20
20
0 1 2 3 4 1 2 3 4 1 2 3 4 1 2 3 4 1 2 5
18 13 15 14 15 14 15 14 15 14 15 14 15 14 15 14 15 14 16 17
18 13 15 14 15 14 15 14 15 14 15 14 15 14 15 14 15 14 16 17
18 13 15 14 15 14 15 14 15 14 15 14 15 14 15 14 15 14 16 17
18 13 15 14 15 14 15 14 15 14 15 14 15 14 15 14 15 14 16 17
18 13 15 14 15 14 15 14 15 14 15 14 15 14 15 14 15 14 16 17
18 13 15 14 15 14 15 14 15 14 15 14 15 14 15 14 15 14 16 17
18 13 15 14 15 14 15 14 15 14 15 14 15 14 15 14 15 14 16 17
18 13 15 14 15 14 15 14 15 14 15 14 15 14 15 14 15 14 16 17
18 13 15 14 15 14 15 14 15 14 15 14 15 14 15 14 15 14 16 17
18 13 15 14 15 14 15 14 15 14 15 14 15 14 15 14 15 14 16 17
18 13 15 14 15 14 15 14 15 14 15 14 15 14 15 14 15 14 16 17
18 13 15 14 15 14 15 14 15 14 15 14 15 14 15 14 15 14 16 17
18 13 15 14 15 14 15 14 15 14 15 14 15 14 15 14 15 14 16 17
18 13 15 14 15 14 15 14 15 14 15 14 15 14 15 14 15 14 16 17
18 13 15 14 15 14 15 14 15 14 15 14 15 14 15 14 15 14 16 17
18 13 15 14 15 14 15 14 15 14 15 14 15 14 15 14 15 14 16 17
18 13 15 14 15 14 15 14 15 14 15 14 15 14 15 14 15 14 16 17
18 13 15 14 15 14 15 14 15 14 15 14 15 14 15 14 15 14 16 17
24 25 26 27 28 26 25 26 27 28 26 25 26 27 28 26 25 26 27 29