20
20
0 1 2 3 4 1 2 3 4 1 2 3 4 1 2 3 4 1 2 5
18 13 15 17 15 14 14 14 15 17 15 14 15 14 15 14 15 14 16 17
18 13 15 17 15 14 15 14 15 17 15 14 15 14 15 14 15 14 16 17
18 13 15 17 25 25 29 14 15 14 15 14 15 14 15 14 15 14 16 17
18 13 15 17 15 14 15 14 15 17 25 25 15 25 25 14 25 25 25 17
18 15 15 14 15 15 15 14 15 17 15 14 15 14 15 14 15 14 16 17
18 13 15 14 15 14 15 14 15 17 15 14 15 14 15 14 15 14 16 17
18 13 15 14 15 14 15 14 15 17 15 14 15 14 15 14 15 14 16 17
18 25 25 14 15 25 25 25 25 29 15 15 25 25 25 25 25 25 25 17
18 13 17 14 15 14 15 14 15 14 15 14 15 14 15 14 15 14 16 17
18 13 17 14 15 14 15 14 15 14 15 14 15 14 15 14 15 17 16 17
18 15 17 15 15 15 15 15 15 15 15 14 15 14 15 14 15 17 16 17
18 13 14 14 15 14 15 14 15 14 15 14 15 14 15 14 15 17 16 17
18 25 25 25 15 14 25 25 25 25 25 25 25 25 25 25 25 29 16 17
18 13 15 14 15 14 18 14 15 17 15 14 15 14 15 5 15 14 16 17
18 13 15 14 15 14 18 14 15 17 15 14 15 14 4 14 15 4 16 17
18 13 15 14 15 14 24 14 27 29 15 14 15 3 4 14 15 14 16 17
18 13 15 14 15 14 15 14 15 14 15 2 15 14 15 14 15 14 16 17
18 13 15 14 15 14 15 14 15 14 15 14 15 14 15 14 2 14 16 17
24 25 26 27 28 26 25 26 27 28 26 25 26 27 28 26 25 26 27 29