20
20
0 1 2 3 4 1 2 3 4 1 2 3 4 1 2 3 4 1 2 5
18 13 15 3 15 14 15 14 15 14 15 14 15 14 15 4 15 14 16 17
18 13 15 14 15 14 15 14 15 14 15 27 25 26 14 27 25 4 16 17
18 13 15 3 15 14 15 14 4 14 15 14 15 14 15 14 15 4 16 17
18 1 2 1 15 14 15 14 4 14 15 2 4 3 1 4 15 25 16 17
18 13 15 3 15 14 15 14 3 14 15 2 15 14 15 4 15 14 16 17
18 13 15 1 3 4 1 2 3 14 15 2 15 14 15 4 26 27 26 17
18 13 15 4 15 14 15 14 3 14 15 14 15 1 15 14 15 14 16 17
18 13 15 4 14 15 14 15 3 14 15 14 15 1 15 14 15 14 16 17
18 13 15 28 28 15 26 25 3 14 15 14 15 4 15 14 15 14 16 17
18 13 15 14 15 14 15 14 15 14 15 14 15 14 15 14 15 14 16 17
18 13 15 14 15 14 15 14 15 14 15 14 15 14 15 14 15 14 16 17
18 13 15 4 4 4 4 4 3 14 15 14 15 4 4 3 14 3 4 17
18 13 15 14 15 14 4 14 15 14 15 14 15 4 15 14 15 14 16 17
18 13 15 14 4 14 15 14 15 14 15 14 15 4 15 14 15 14 16 17
18 13 4 4 4 14 4 14 15 4 4 2 3 4 4 3 25 26 27 17
18 13 4 14 15 14 4 4 4 3 15 14 15 14 15 4 15 14 16 17
18 13 4 14 15 14 15 14 15 14 15 14 15 14 15 26 25 14 26 17
18 13 15 14 15 14 15 14 15 14 15 14 15 14 15 14 15 14 16 17
24 25 26 27 28 26 25 26 27 28 26 25 26 27 28 26 25 26 27 29